00010101010100000101000
01110001110101110001010
01000100100100100101110
01110101110101110100100
00000100010101000101110
01111101110111110100010
01000100000100000111000
00010111110101110101110
11110100010100100100010
00000101010101110101010
01011101000101000101110
01110111110101111100000
00000100000100000111010
11100111010101110101010
00110101110101000101110
00100100000101110100000
01100101010100100101011
00000101110101110101110
011111001001010001001S0
01000101110101110101110
01E10101010100010101000
01110101010001110101110
00000100010101000100000
