1 1 1 255 1 255 1 255 1 1 1 255 1 255 1 255 1 255 1 255 1 255 END 
1 255 1 1 1 255 1 255 255 255 1 1 1 255 1 255 1 255 1 255 1 255 1 
1 255 1 255 1 255 1 255 1 255 1 255 1 255 1 255 1 255 1 255 1 255 1 
1 255 255 255 1 1 1 255 1 1 1 255 1 1 1 255 1 1 1 255 1 1 1 
1 1 1 255 255 255 1 255 1 255 255 255 1 255 1 255 1 255 1 255 1 255 255 
255 255 1 255 1 255 1 255 1 255 1 255 255 255 1 255 1 255 255 255 1 1 1 
1 255 1 255 1 255 1 255 1 1 1 255 1 255 1 255 1 1 1 255 255 255 1 
1 1 1 255 1 1 1 255 1 255 1 255 1 1 1 255 1 255 1 255 1 1 1 
1 255 255 255 255 255 1 255 255 255 1 255 1 255 255 255 255 255 1 255 1 255 255 
1 1 1 255 1 1 1 255 1 255 1 255 1 255 1 255 1 1 1 255 1 255 1 
1 255 1 255 1 255 255 255 1 1 1 255 1 1 1 255 1 255 255 255 1 1 1 
255 255 1 255 1 1 1 255 1 255 255 255 255 255 1 255 1 1 1 255 1 255 1 
1 255 1 255 1 255 1 255 1 255 1 255 1 1 1 255 1 255 1 255 255 255 1 
1 1 1 255 255 255 1 255 1 1 1 255 1 255 1 255 1 255 255 255 1 1 1 
255 1 255 255 1 1 1 255 1 255 1 255 255 255 1 255 1 255 1 255 1 255 255 
1 1 1 255 1 255 255 255 1 255 255 255 1 1 1 255 1 1 1 255 1 1 1 
255 255 1 255 1 255 1 255 1 1 1 255 1 255 1 255 1 255 1 255 1 255 1 
1 255 1 255 1 255 1 255 255 255 1 255 1 255 255 255 255 255 1 255 255 255 1 
1 1 1 255 1 1 1 255 1 1 1 255 11 255 1 255 1 255 1 255 1 1 1 
1 255 255 255 255 255 1 255 1 255 255 255 1 1 1 255 1 1 1 255 1 255 255 
1 255 START 255 1 1 1 255 1 255 1 255 1 255 1 255 1 255 1 255 1 255 1 
1 255 1 255 255 255 1 1 1 255 1 255 1 255 1 1 1 255 1 1 1 255 1 
1 1 1 255 1 1 1 255 1 1 1 255 1 255 1 255 1 255 1 255 1 1 1 
